##     ##    ###    #### ##    ##      ######   #######  ##    ## ######## ########   #######  ##
###   ###   ## ##    ##  ###   ##     ##    ## ##     ## ###   ##    ##    ##     ## ##     ## ##
#### ####  ##   ##   ##  ####  ##     ##       ##     ## ####  ##    ##    ##     ## ##     ## ##
## ### ## ##     ##  ##  ## ## ##     ##       ##     ## ## ## ##    ##    ########  ##     ## ##
##     ## #########  ##  ##  ####     ##       ##     ## ##  ####    ##    ##   ##   ##     ## ##
##     ## ##     ##  ##  ##   ###     ##    ## ##     ## ##   ###    ##    ##    ##  ##     ## ##
##     ## ##     ## #### ##    ##      ######   #######  ##    ##    ##    ##     ##  #######  ########